a	à
afin	affin
aux	aux
au	au
ausquelz	auxquels
abatuë	abattu
absolus	absolu
accompagne	accompagne
acquerir	acquerre
acquerre	aquerir
aquerir	acquerir
acte	acte
acteurs	actrices
adieu	adieu
adonc	adonc
adorable	adorable
adraste	adraste
aage	âge
agreables	agréable
ah	ah
aydé	aidé
aymable	aimable
ayme	aime
aymer	aymer
aymer	aimer
aymez	aimés
ainé	aîné
ainsi	ainsi
ainsi	ainsy
ayse	aise
aysé	aisé
aysément	aysement
aysément	aisément
adjouste	ajoute
alcidon	alcidon
aléxandre	alexandre
alloit	alloit
alloit	allait
allèrent	allerent
vay	vais
vont	va
alors	alors
alteration	altération
ame	ame
amer	amères
amys	amis
amis	amis
amy	amie
amy	amy
amy	ami
amye	amie
amitiez	amitiés
amour	amour
amour	amours
amoureuse	amoureuse
amoureux	amoureux
amusemens	amusements
anglois	anglais
annee	année
antire	antire
août	aoust
apotre	apôtre
apparence	aparence
appelle	appella
apella	appella
appellé	appellés
appellés	apellé
apellé	appellé
apporte	apporte
apprens	apprends
apprennent	apprenent
apprendre	aprendre
appris	apris
approchez	approchez
aprochant	approchant
appuy	appui
apres	après
apres	apres
après	après
arbres	arbres
archer	archier
ardant	ardent
argument	argument
arrester	arrêter
arresté	arrêté
arrivay	arrivai
asile	azile
assaults	assauts
assez	assés
asseurance	assurance
asseurément	assurément
asseurer	assurer
asseuré	assuré
attendez	attendez
attens	attends
aucun	aucun
aujourd'hui	aujourdhui
aujourd'hui	aujourd'huy
aupres	auprès
aussi	aussi
aussi	aussy
aussitost	aussitost
aussitost	aussytost
autant	autant
autour	autour
autres	autres
autresfois	autrefois
autrefois	autrefois
autrement	autrement
avant	avant
avec	avec
avec	avecques
avec	avecque
avec	aveq
aveq	avecques
aveq	avecque
advantures	avantures
advanture	aventure
aventure	avanture
adverty	averti
aveus	aveux
avis	avis
auroient	auroient
auroient	auraient
auroit	aurait
auray	aurai
aura	aura
avois	avais
avoyent	avoient
avoient	avoient
avoient	avaient
avoit	avoit
avoit	avois
avoit	avait
eurent	eurent
eut	eust
eut	avoit
ay	ay
ay	ai
avez	ayiez
avez	avez
ont	ha
ont	ont
ha	ay
ha	a
a	ay
a	a
a	ayt
a	avoit
eusse	eusse
eust	eust
eust	eût
aye	aie
aie	aies
ayent	aient
ayt	ait
avoir	avoir
ayant	ayant
advouë	avouë
bâtard	bâtards
beronte	beronte
besoing	besoin
bestes	bêtes
beste	bête
bien	bien
bien	biens
beuvant	beuvans
boys	bois
bons	bons
boucher	bouchere
brebis	brebis
brûler	bruler
bruslé	brulé
caliste	caliste
camp	camp
campaigne	campagne
canon	canon
cantorberi	cantorbery
car	car
caractère	caractere
carosse	carrosse
cavaliers	cavaliers
cavalier	cavalier
cest	ces
ces	ces
ceste	celle
ceste	cette
cette	cette
cette	cét
cette	celle
ce	cét
ce	ce
ce	cet
cet	cet
ce	c'
c'	c'
cela	cela
celà	cela
célèbre	célebre
celestes	célestes
ceux	ceux
celuy	ceux
ceux	celles
cil	celle
celle	celuy
celuy	celuy
ceux	celui
celui	celui
celuy	cela
cent	cens
cependant	cepandant
cependant	cependant
certain	certain
certes	certes
césar	césars
chacun	chacun
changemens	changements
cahos	chaos
chapitre	chapitre
chaque	chaque
charmés	charmé
chastiment	châtiment
chauld	chault
cherchoit	cherchait
cherchant	cherchant
chievres	chievres
chiens	chiens
choque	choque
chrétien	chrêtien
chrêtiens	chrétiens
cheute	chûte
chûte	chute
cy	-ci
-ci	ci
-ci	-cy
ciceron	cicéron
ciel	ciel
cieux	cieux
clere	claire
clarinde	clarinde
clarté	clairté
cleandre	cleandre
colere	colère
comme	comme
commencemens	commencements
comment	coment
coment	coment
compaignie	compagnie
compaing	compagnon
comprens	comprends
comte	comte
comtesse	comtesse
conçoy	conçois
connoissance	connaissance
connois	connoissois
connoissons	connaissons
connoître	connaître
congnoissant	cognoissant
cognoissant	connoissant
congnu	cognu
cognu	connu
conquérant	conquérans
consequence	conséquence
conserve	conserve
contre	contre
contre	contr
contree	contrée
costez	côtez
côtez	côtés
couché	couché
coulpable	coupable
coupable	coupables
cour	cour
coronne	couronne
courrier	couriers
courrier	courrier
couté	coûté
coûtumes	coutumes
craingnans	craignant
crier	crier
crisante	crisante
croy	croi
croi	crois
crû	cru
croissoyent	croissaient
croissant	croissants
cruelles	cruelles
cure	cure
danemarck	dannemarck
dens	dens
dens	dans
dans	dans
de	de
de	d'
d'	d'
du	des
des	des
du	du
desquelz	desquelz
decembre	decembre
decembre	décembre
descouvert	découvert
desdaing	dédain
dedens	dedans
dedans	dedans
deffaire	défaire
deffend	deffende
deffend	défend
deffendre	défendre
deffendu	défendu
deffence	défense
deffit	deffis
desjà	desja
desja	déja
déja	deja
déja	déjà
déja	déja
demande	demandes
demy	demy
demy	demi
despart	départ
deplorable	deplorable
deplorable	déplorable
deposition	déposition
depuis	depuis
derniere	derniére
derniere	derniere
dès	dés
dès	dès
desarmé	désarmé
descendans	descendants
descend	descende
desesperée	désespéré
desespoir	désespoir
desir	desirs
desirs	désirs
desire	desire
désire	desire
desormais	désormais
dessoubs	dessous
dessus	dessus
destruit	détruit
destruire	détruire
dueil	deuil
deutéronome	deuteronome
deux	deux
devant	devant
devienne	devient
devenuë	devenue
debvoir	devoir
devroit	devrait
devoit	devait
doy	dois
dois	devois
doyvent	doivent
doit	doit
doit	doibt
dieux	dieux
dieux	dieu
dieu	dieu
difference	différence
différents	différens
difficille	difficile
difficultéz	difficultez
difficultez	difficultés
dignité	dignités
dites	dites
dis	dis
diray	dirai
disait	disoit
dit	disoit
diroit	dit
disants	disant
discretion	discrétion
disposer	disposer
divertissemens	divertissements
divinité	divinité
domestique	domestiques
donc	donq
donq	donq
donnèrent	donnerent
donne	donnai
donner	donner
dorilas	dorilas
doulce	douce
duc	druides
durée	dureté
droit	duc
esbahys	esbahy
éclairés	éclairé
escouter	écouter
écoûté	écouté
écrivait	écrivit
écrivit	écrivoit
écrivis	écrivois
escrit	écrit
effect	effet
esgaré	égaré
eh	eh
eslections	élections
élevé	élevés
eslongner	éloigner
eslongné	éloigné
embrassés	embrassé
empeschoit	empêchoit
empesche	empèche
empescher	empêcher
emportés	emporté
en	en
encor	encor
encor	encores
encor	encore
encore	encore
endort	endorme
enfans	enfants
enfant	enfant
enfin	enfin
enfraindre	enfreindre
ennemie	ennemy
ennemy	ennemies
ennemis	ennemys
ennemi	ennemy
ennuy	ennuys
ennuys	ennuis
entens	entends
entiére	entiere
entierement	entiérement
entre	entre
environ	environ
envoye	envoie
espee	espée
espée	épée
épousée	épousé
espaigne	espagne
espèces	especes
espece	espèce
esperances	espérances
esperance	espérance
et	&
et	et
estat	états
estat	état
estaindre	esteindre
esteindre	éteindre
estendre	étendre
eternels	éternelle
éternelle	éternelles
estonné	étonné
estouffer	étouffer
estranges	étranges
estrange	étrange
étrangéres	étrangers
seroit	serait
serons	serons
étois	etois
estoyent	estoient
estoient	étoient
étoient	étaient
estois	estoit
estoit	estoit
estoit	étois
étois	étoit
étoit	était
furent	fussent
fust	fut
suis	suis
estes	êtes
êtes	etes
sont	sont
est	est
étoit	fût
soyent	soyent
soyent	soient
soit	soit
estre	estre
estre	être
estant	estant
estant	étant
esté	été
evenemens	événements
evenement	événement
eviter	éviter
exceds	excès
extremes	extrêmes
extreme	extréme
extréme	extrême
faschee	fâchée
facilement	facilement
foible	faible
faible	foibles
foibles	foible
firent	feroient
feroit	feroit
feroit	ferait
fera	fera
faisoyent	faisoient
faisoient	faisaient
faisait	faisoit
fit	fit
font	font
feit	fait
fait	fait
face	fasse
feirent	faire
faisant	faisant
faudroit	faudrait
fallait	falloit
fallut	falut
fault	faut
faut	faut
faunes	faunus
favorables	favorable
feux	feuz
fueilles	feuilles
fidelité	fidélité
flames	flammes
flamme	flame
flateuses	flatteuses
foy	foi
fontaine	fontaine
forestz	forests
forestz	forêts
frappés	frappé
frere	fréres
fréres	freres
frere	frere
frere	frére
frére	frére
fuyr	fuir
fuyte	fuite
fuite	fuitte
gaigné	gagné
gayeté	gaieté
gaulois	gaulois
generale	génerale
génerale	générale
générale	général
genereuse	genereuse
genereux	genereux
genereux	généreux
geolier	geolier
grands	grandes
grands	grans
grands	grands
grand'	grande
grand	grans
grand	grand
gravés	gravé
guéres	guères
guères	guère
guère	gueres
gueres	guere
guerir	guérir
guere	guerres
guis	gui
ha	ha
ha	hà
habitant	habitans
habitans	habitants
hayne	haine
alaine	haleine
hazard	hasard
haults	haultes
haults	hault
haulte	haute
hault	haut
hé	he
hébreux	hebreux
helas	helas
helas	hélas
hélas	hélas
heureuse	heureuse
heureux	heureux
yver	hiver
homme	homme
honnestes	honnêtes
honneste	honnête
honneur	honneur
hors	hors
humble	humble
humble	humbles
hymen	hymen
hypppolite	hyppolite
hyppolite	hippolite
icy	icy
icy	ici
il	il
-leur	luy
luy	la
la	la
le	luy
le	le
elles	elles
elles	-elles
elles	leur
ilz	ils
ils	ils
ils	-ils
leur	leur
leur	la
leur	-la
elle	elle
elle	-elle
elle	-t-elle
la	-la
leur	le
le	-le
luy	luy
luy	leur
il	-il
-il	-t-il
-t-il	il
luy	lui
lui	lui
lui	-lui
impossible	impossible
impression	impressions
indifference	indifférence
infidelle	infidele
instruments	instrumens
intelligens	intelligents
interest	interêt
interêt	intérêt
invincible	invincible
jà	jà
jadis	jadis
jalousé	jalousés
jamais	jamais
moy	moi
moi	-moi
moi	moi
je	je
je	j'
je	-je
-je	j'
me	m'
me	me
jetté	jettés
joye	joie
joints	joints
jouïr	jouir
joyeuse	joyeux
juge	juges
jugés	jugé
juridiques	juridique
jusqu'	jusques
jusqu'	jusqu'
justice	justice
là	là
là	-là
lasche	làche
làches	lâches
lâchement	làchement
lacheté	lâcheté
lâcheté	làcheté
laissait	laissoit
laissa	laissast
làs	làs
l	les
les	les
la	l'
la	le
le	l'
le	les
y	en
y	les
legers	leger
leger	léger
legitime	légitimes
légitimes	légitime
legitime	légitime
leon	leon
leon	léon
lesquelz	lesquelz
lesquelles	laquelle
lesquelles	lesquels
lesquels	laquelle
laquelle	lequel
lettre	lettre
libertez	libertés
libre	libres
lidian	lidian
liens	lyens
lieu	lieu
lieuës	lieues
limité	limité
leu	lû
lû	lu
lisandre	lisandre
lisandre	lucidan
lict	lit
livre	liv
loix	loy
loix	loi
loing	loing
loing	loin
loysir	loisir
longtemps	longtems
lors	lords
lors	lors
lorsque	lorsque
lorsque	lorsqu'
treslouable	loüable
loüanges	louanges
loup	loups
lucidan	lucidan
lumiéres	lumieres
lyon	lyon
madame	madame
madame	madale
mademoiselle	mademoiselle
mai	may
main	pareille
maints	maints
mais	mais
maître	maître
maitresse	maîtresses
maistresse	maîtresse
maîtresse	maitresse
majesté	m
mal	maux
mal	mal
mandez	mandiez
maniéres	manieres
maniere	manière
mary	mary
mary	mari
marièrent	maria
marquise	marquise
mars	mars
matin	matin
meschanceté	méchanceté
meschants	méchants
mesmes	mêmes
mesme	même
-mesme	même
mesmes	mesme
même	mêmes
memoire	mémoire
mène	mene
mente	ments
mespris	mépris
mer	mer
mere	mere
mere	mére
merite	mérite
merite	merite
meriter	mériter
merité	mérité
mestier	métier
mit	mettoit
mydi	midi
mille	mille
misere	misére
missionaires	missionnaires
modestement	modestement
moins	moins
moys	mois
mes	mes
ma	mon
ma	ma
mon	mon
mon	m
monarques	monarques
monseigneur	monseigneur
m	m
m	madame
madame	monsieur
monsieur	monsieur
monsieur	m
monsieur	mr.
monter	monter
montee	montée
monstre	monstre
monstre	montre
monstrer	montrer
monument	monument
nefas	addita
morts	mords
mouvements	mouvemens
nees	nées
nez	nés
ne	n'
neantmoins	néanmoins
necessaire	nécessaire
necessairement	nécessairement
necessité	nécessité
ne	ne
ne	ny
ny	ny
ny	ni
ni	ni
ni	n'
nos	nos
noz	nos
nostre	notre
notre	notre
nostre	nôtre
nôtre	notre
nourris	nourris
nous	nous
nous	-nous
nouveau	nouvel
novembre	novembre
nuict	nuit
nymphe	nymphes
o	ô
obeïr	obeyr
obeissant	obéissant
obeissance	obéissance
obligé	obligés
octobre	octobre
offence	offense
offencé	offensé
ô	oh
oh	oh
oyseau	oyseaux
oyseaux	oiseau
on	-on
undes	ondes
onc	onc
onc	onques
opposés	opposé
or	ore
or	or
ores	ores
orme	orme
ornement	ornements
ostoient	ôtaient
ostent	ôtèrent
oster	ôter
ou	ou
ouy	ouï
ouï	oui
oui	oui
oyant	oyant
oultre	outre
pair	pairs
par	par
par	là
parce	pource
paroistroient	parust
paraissait	paroît
paroît	paroissoit
parust	paroîtra
paroist	paraît
paraît	paroît
paraistre	paroître
pareils	pareils
parens	parents
paresseux	paresseux
parloit	parlait
parlai	parle
parmy	parmi
particulièrement	particuliérement
particuliérement	particulierement
partie	partie
passait	passa
passeroit	passe
patience	patience
pauvre	pauvre
povreté	pauvreté
peau	peaux
peines	peynes
peine	peyne
pendant	pendant
pensee	pensée
penser	pensers
pensoyent	pensoient
pensoient	pensaient
penses	penses
perd	perde
pere	peres
pére	pere
pere	pere
pere	p
p	pére
perfide	perfide
perilz	perils
peril	péril
perir	périr
personne	personne
petit	petit
peu	peu
peuplés	peuplé
pieté	piété
pilote	pilotte
playe	plaie
pleins	plains
plein	plein
plorer	pleurer
plûpart	plupart
plus	plus
plustost	plustost
plustost	plûtôt
plûtôt	plutôt
poingnants	poingnans
point	poinct
point	points
policés	policé
portait	portoit
pourtrait	portrait
possede	possede
posseder	posséder
pour	pour
pourquoy	pourquoi
pourquoi	pourquoi
poussez	poussez
pourrois	pourrois
purent	pourroient
pourroient	pourront
pourroit	pourroit
pourroit	pourrait
povois	pouvois
pouvoient	pouvaient
pouvoit	pouvait
pouvait	pouvait
puis	puis
puis	pourray
peult	peut
peut	peut
puisse	puisse
pouvans	pouvant
pû	pu
premiers	premiéres
premiers	premieres
premiere	premiere
premiere	pressante
pressante	premiére
premiére	première
première	premiere
premier	premier
premier	première
premierement	premiérement
prens	prends
prenoyent	prenaient
prenaient	prenoient
prend	prend
pres	pres
pres	près
pres	prés
presence	présence
present	présent
present	presens
presens	présents
presenté	présenté
presque	presque
presque	presqu'
prestes	prêtes
prest	prêt
prétendaient	prétendoient
prières	prieres
prince	prince
princesse	princesse
printemps	printemps
procedé	procédé
procedent	procèdent
prochaines	prochains
propos	propos
prosperer	prospérer
prosperité	prospérité
protestans	protestants
preuve	prouve
provinces	provinces
publics	publique
puisque	puisque
puisque	puisqu'
puissans	puissants
quand	quand
quant	quant
qu'	que
que	que
qu'	qu'
que	ce
quoi	quoi
que	où
où	où
qu'	quoi
ou	dont
ou	qu'
ou	que
que	dont
qu'	dont
où	qu'
dont	où
dont	dont
que	quoi
quelle	quelle
quel	quel
quelcun	quelqu'un
quelques	quelques
quelque	quelque
quelquesfois	quelquesfois
quelquesfois	quelquefois
qui	qui
qui	qu'
quittez	quittez
quoy	quoi
quoy	quoy
quoique	quoiqu'
reçus	reçûs
reçuë	reçue
reçeu	reçu
recongnoit	reconnait
reconnait	reconnaissait
recognoit	reconnait
reconaistre	reconnaître
regles	régles
régne	regne
regner	régner
resjouyr	réjouir
relàche	relâche
remord	remords
rendray	rendrai
rendra	rendra
rendent	rendent
rend	rend
respandu	répandu
réplique	réplique
respondray	répondrai
répondrai	répons
respond	répond
respondre	répondre
responce	réponse
réponse	réponse
reputation	réputation
résignation	resignation
resister	résister
resonnants	resonants
resout	resolut
resoudre	résoudre
respectable	respectables
restoit	resta
retiré	rétirés
retournera	retourna
réünis	réunis
reussir	réussir
r	r
rocz	rocz
rocher	rocher
roys	rois
rois	rois
roy	roy
roy	roi
royale	royale
ruës	rues
ruyne	ruine
ruisseaux	ruisseaux
st	saint
sans	sans
sçaurois	saurois
sçauroit	sauroit
sçauroit	saurait
saurait	sauroit
sçavois	savois
sçavoyent	savaient
sçait	savait
sceut	sut
sçay	sçache
sçay	sçai
sçai	sais
sçavez	sçauriez
sçauriez	sçaviez
sçaviez	sçavez
sçavez	sçavez
sçavez	savez
sçavent	sûrent
sûrent	savent
sçait	sait
sçache	sache
sçavoir	savoir
sceu	sçeu
sceu	sçû
sçû	sçu
sçu	su
se	se
second	seconds
seigneur	seigneur
sejour	séjour
selon	selon
semble	semble
sentimens	sentiments
separe	sépare
septembre	septembre
servait	servoit
serve	sers
seul	seul
severe	sévère
si	si
si	s'
siecle	siécle
miens	nôtres
sienne	tienne
sien	leur
simplicité	simplicité
singulier	singuliéres
sire	sire
société	societé
soy	soi
soings	soins
soing	soin
soleil	soleil
solitaire	solitaire
nostre	mon
leurs	leurs
leurs	ses
ses	ses
sa	son
sa	leur
leur	son
sa	sa
son	son
sort	sort
sortirent	sortent
sort	sorte
souffrez	souffrez
souffert	soufert
souper	soupers
soubs	soubs
soubs	soubz
soubs	sous
soustiennent	soûtiennent
soustenir	soûtenir
soûtenir	soutenir
soustenu	soutenu
souvent	souvent
substitué	substitués
succez	succès
suyte	suite
suite	suite
suivante	suivante
suivez	suivez
suis	suy
suyvir	suyvre
suyvre	suivre
suivant	suivant
subjets	sujets
subjet	sujet
sur	sur
sur	sus
seurs	surs
seure	seure
seure	sûre
seur	sûr
seurement	seurement
seureté	sureté
talens	talents
tant	tant
tante	tantes
tante	tante
tantost	tantost
tantost	tantôt
telz	tels
telz	telles
tesmoigner	témoigner
templier	templiers
temps	tems
terrain	terrein
teste	tête
tiltre	titre
tes	tes
ta	ta
ta	ton
ton	ton
tost	tost
tost	tôt
tousjours	toûjours
toûjours	toujours
torments	tourmens
tourmens	tourments
tormente	tourmente
toute	tout
tout	tout
tout	toutes
toute	toutes
tous	tous
toute	toute
traîtres	traitres
travaillons	travaillerons
trempee	trempée
tres	tres
tres	très
thresors	tresors
tresors	trésors
tresor	trésor
triomphent	triomphent
trois	trois
troisiesme	troisième
trompe	trompa
trop	trop
trouviez	trouveriez
trouveroit	trouvât
trouvât	trouvoit
trouverent	trouvèrent
trouva	trouvoit
trouvez	trouvez
treuve	trouve
trouver	treuver
trouvé	treuvé
trouvé	trouvé
toy	toi
toi	-toi
toi	toi
tu	tu
tu	-tu
te	te
tué	tués
tyrans	tyrans
tirant	tyran
une	une
de	un
de	des
un	un
unir	unir
valet	valet
valee	vallee
vault	vaut
vaut	valent
vault	valoir
varasque	varasque
venerable	venérable
venérable	vénérable
vangent	vengent
vange	vange
vanger	venger
vindrent	viendraient
venez	venez
venoit	venait
vins	venois
vindrent	vinrent
vinst	vint
venez	veniez
vient	vient
venir	vien
veritable	véritable
verité	vérité
victorieux	victorieuse
vie	vie
vifz	vifs
vivoit	vivait
vit	vid
vid	vécut
vécut	vit
veuz	veux
veux	voeux
voicy	voicy
voicy	voici
voici	voici
voyes	voies
voila	voyla
voila	voila
voila	voilà
verroit	virent
verroit	voyoit
voyez	voyez
verray	verrai
voyait	voyoit
veissent	virent
voy	vois
voy	voye
voy	voi
voi	voye
voi	vois
vois	vis
voit	voy
voy	void
void	voit
voise	voye
voye	void
voyant	voyans
voyant	voyant
veu	veu
veu	veuë
veu	vû
vû	vu
voire	voire
volontez	volontés
voulenté	volonté
voluptueux	voluptueuse
vos	vos
voz	vos
vostre	votre
vostre	v
v	votre
votre	votre
vostre	vostre
vostre	vôtre
vôtre	votre
voudroit	voudroit
voudroit	voudrait
vouloit	voulût
voulût	voulait
voulait	vouloit
voulut	voulut
vueille	veuille
vous	vous
vous	-vous
vray	vrays
vray	vrai
