afin	affin
ausquelz	auxquels
abatuë	abattu
acquerir	acquerre
acquerre	aquerir
aquerir	acquerir
aage	âge
aydé	aidé
aymable	aimable
ayme	aime
aymer	aimer
ainé	aîné
ainsi	ainsy
ayse	aise
aysé	aisé
aysément	aysement
aysément	aisément
aléxandre	alexandre
alloit	allait
allèrent	allerent
vay	vais
alteration	altération
amys	amis
amye	amie
amitiez	amitiés
amusemens	amusements
anglois	anglais
annee	année
août	aoust
apotre	apôtre
apparence	aparence
apellé	appellé
apprens	apprends
apprennent	apprenent
apprendre	aprendre
appris	apris
aprochant	approchant
appuy	appui
apres	après
archer	archier
ardant	ardent
arrester	arrêter
arresté	arrêté
arrivay	arrivai
asile	azile
assaults	assauts
assez	assés
asseurance	assurance
asseurément	assurément
asseurer	assurer
asseuré	assuré
attens	attends
aupres	auprès
aussi	aussy
aussitost	aussytost
autresfois	autrefois
avec	avecques
avec	avecque
avec	aveq
aveq	avecques
aveq	avecque
advantures	avantures
advanture	aventure
aventure	avanture
adverty	averti
aveus	aveux
auroient	auraient
auroit	aurait
auray	aurai
avois	avais
avoyent	avoient
avoient	avaient
avoit	avois
avoit	avait
eut	eust
ay	ai
avez	ayiez
ha	ay
ha	a
a	ay
eust	eût
aye	aie
ayent	aient
ayt	ait
advouë	avouë
besoing	besoin
bestes	bêtes
beste	bête
beuvant	beuvans
boys	bois
brûler	bruler
bruslé	brulé
campaigne	campagne
cantorberi	cantorbery
caractère	caractere
carosse	carrosse
cest	ces
ceste	cette
ceste	cette
cette	cét
celà	cela
célèbre	célebre
celestes	célestes
celui	celuy
cependant	cepandant
changemens	changements
cahos	chaos
chastiment	châtiment
chauld	chault
cherchoit	cherchait
chrétien	chrêtien
chrêtiens	chrétiens
cheute	chûte
ciceron	cicéron
clere	claire
clarté	clairté
colere	colère
commencemens	commencements
comment	coment
compaignie	compagnie
comprens	comprends
conçoy	conçois
connoissance	connaissance
connoissons	connaissons
connoître	connaître
congnoissant	cognoissant
cognoissant	connoissant
congnu	cognu
cognu	connu
conquérant	conquérans
consequence	conséquence
contre	contr
contree	contrée
costez	côtez
coulpable	coupable
coronne	couronne
couté	coûté
coûtumes	coutumes
craingnans	craignant
croy	croi
croi	crois
crû	cru
croissoyent	croissaient
danemarck	dannemarck
dens	dans
decembre	décembre
descouvert	découvert
desdaing	dédain
dedens	dedans
deffaire	défaire
deffend	défend
deffendre	défendre
deffendu	défendu
deffence	défense
deffit	deffis
desjà	desja
desja	déja
déja	deja
déja	déjà
demy	demi
despart	départ
deplorable	déplorable
deposition	déposition
derniere	derniére
desarmé	désarmé
descendans	descendants
desespoir	désespoir
desir	desirs
desirs	désirs
désire	desire
desormais	désormais
dessoubs	dessous
destruit	détruit
destruire	détruire
dueil	deuil
deutéronome	deuteronome
devenuë	devenue
debvoir	devoir
devroit	devrait
devoit	devait
doy	dois
dois	devois
doyvent	doivent
doit	doibt
difference	différence
différents	différens
difficille	difficile
difficultéz	difficultez
difficultez	difficultés
diray	dirai
disait	disoit
dit	disoit
disants	disant
discretion	discrétion
divertissemens	divertissements
donc	donq
donnèrent	donnerent
doulce	douce
esbahys	esbahy
escouter	écouter
écoûté	écouté
écrivis	écrivois
escrit	écrit
effect	effet
esgaré	égaré
eslections	élections
eslongner	éloigner
eslongné	éloigné
empeschoit	empêchoit
empesche	empèche
empescher	empêcher
encor	encores
encor	encore
enfans	enfants
enfraindre	enfreindre
ennemie	ennemy
ennemis	ennemys
ennemi	ennemy
ennuys	ennuis
entens	entends
entiére	entiere
entierement	entiérement
envoye	envoie
espee	espée
espée	épée
espaigne	espagne
espece	espèce
esperances	espérances
esperance	espérance
et	&
estat	état
estaindre	esteindre
esteindre	éteindre
estendre	étendre
eternel	éternelle
estonné	étonné
estouffer	étouffer
estranges	étranges
estrange	étrange
étrangéres	étrangers
seroit	serait
étois	etois
estoyent	estoient
estoient	étoient
étoient	étaient
estois	estoit
estoit	étois
étois	étoit
étoit	était
fust	fut
estes	êtes
êtes	etes
soyent	soient
estre	être
estant	étant
esté	été
evenemens	événements
evenement	événement
eviter	éviter
exceds	excès
extremes	extrêmes
extreme	extréme
extréme	extrême
faschee	fâchée
foible	faible
feroit	ferait
faisoyent	faisoient
faisait	faisoit
feit	fait
face	fasse
feirent	faire
faudroit	faudrait
fallait	falloit
fallut	falut
fault	faut
faunes	faunus
feux	feuz
fueilles	feuilles
flames	flammes
flamme	flame
flateuses	flatteuses
foy	foi
forestz	forests
forestz	forêts
fréres	freres
frere	frére
fuyr	fuir
fuyte	fuite
fuite	fuitte
gaigné	gagné
gayeté	gaieté
generale	génerale
génerale	générale
genereux	généreux
grands	grans
grand	grans
guéres	guères
guis	gui
habitant	habitans
habitans	habitants
hayne	haine
alaine	haleine
hazard	hasard
haulte	haute
hault	haut
hébreux	hebreux
helas	hélas
yver	hiver
honnestes	honnêtes
honneste	honnête
hyppolite	hippolite
icy	ici
ilz	ils
luy	lui
indifference	indifférence
infidelle	infidele
instruments	instrumens
intelligens	intelligents
interest	interêt
interêt	intérêt
moy	moi
joye	joie
jouïr	jouir
lasche	làche
làches	lâches
lâchement	làchement
lacheté	lâcheté
lâcheté	làcheté
laissait	laissoit
laissa	laissast
leger	léger
legitime	légitime
leon	léon
libertez	libertés
liens	lyens
lieuës	lieues
leu	lû
lû	lu
lict	lit
loix	loy
loix	loi
loing	loin
loysir	loisir
longtemps	longtems
lors	lords
loüanges	louanges
lumiéres	lumieres
mai	may
maistresse	maîtresse
maîtresse	maitresse
maniéres	manieres
maniere	manière
mary	mari
meschanceté	méchanceté
meschants	méchants
mesmes	mêmes
mesme	même
memoire	mémoire
mène	mene
mespris	mépris
mere	mére
merite	mérite
meriter	mériter
merité	mérité
mestier	métier
mydi	midi
misere	misére
missionaires	missionnaires
moys	mois
montee	montée
monstre	montre
monstrer	montrer
mouvements	mouvemens
nees	nées
nez	nés
neantmoins	néanmoins
necessaire	nécessaire
necessairement	nécessairement
necessité	nécessité
ny	ni
noz	nos
nostre	notre
nostre	nôtre
nôtre	notre
nuict	nuit
o	ô
obeïr	obeyr
obeissant	obéissant
obeissance	obéissance
offence	offense
offencé	offensé
oyseau	oiseau
undes	ondes
onc	onques
or	ore
ostoient	ôtaient
ostent	ôtèrent
oster	ôter
ouy	ouï
ouï	oui
oultre	outre
parce	pource
paroist	paraît
paraît	paroît
paraistre	paroître
parens	parents
parloit	parlait
parmy	parmi
particulièrement	particuliérement
particuliérement	particulierement
povreté	pauvreté
peines	peynes
peine	peyne
pensee	pensée
pensoyent	pensoient
pensoient	pensaient
pére	pere
perilz	perils
peril	péril
perir	périr
pieté	piété
pilote	pilotte
playe	plaie
pleins	plains
plorer	pleurer
plûpart	plupart
plustost	plûtôt
poingnants	poingnans
point	poinct
portait	portoit
pourtrait	portrait
posseder	posséder
pourquoy	pourquoi
pourroit	pourrait
povois	pouvois
pouvoient	pouvaient
pouvoit	pouvait
peult	peut
pouvans	pouvant
pû	pu
premiére	première
première	premiere
premierement	premiérement
prens	prends
prenoyent	prenaient
prenaient	prenoient
pres	près
pres	prés
presence	présence
present	présent
present	presens
presens	présents
presenté	présenté
prestes	prêtes
prest	prêt
prétendaient	prétendoient
prières	prieres
procedé	procédé
procedent	procèdent
prosperer	prospérer
prosperité	prospérité
protestans	protestants
preuve	prouve
puissans	puissants
quoy	quoi
reçus	reçûs
reçuë	reçue
reçeu	reçu
recongnoit	reconnait
recognoit	reconnait
reconaistre	reconnaître
regles	régles
régne	regne
regner	régner
resjouyr	réjouir
relàche	relâche
rendray	rendrai
respandu	répandu
respondray	répondrai
respond	répond
respondre	répondre
responce	réponse
reputation	réputation
résignation	resignation
resister	résister
resonnants	resonants
resout	resolut
resoudre	résoudre
restoit	resta
réünis	réunis
reussir	réussir
roys	rois
roy	roi
ruës	rues
ruyne	ruine
sçaurois	saurois
sçauroit	sauroit
sçauroit	saurait
saurait	sauroit
sçavois	savois
sçavoyent	savaient
sçait	savait
sceut	sut
sçay	sçai
sçai	sais
sçavez	savez
sçait	sait
sçache	sache
sçavoir	savoir
sceu	sçeu
sceu	sçû
sçû	sçu
sçu	su
sejour	séjour
sentimens	sentiments
separe	sépare
servait	servoit
severe	sévère
siecle	siécle
soy	soi
soings	soins
soing	soin
souffert	soufert
soubs	soubz
soubs	sous
soustiennent	soûtiennent
soustenir	soûtenir
soûtenir	soutenir
soustenu	soutenu
succez	succès
suyte	suite
suis	suy
suyvir	suyvre
suyvre	suivre
subjets	sujets
subjet	sujet
seurs	surs
seure	sûre
seur	sûr
seureté	sureté
talens	talents
tantost	tantôt
telz	tels
tesmoigner	témoigner
temps	tems
teste	tête
tiltre	titre
tost	tôt
tousjours	toûjours
toûjours	toujours
torments	tourmens
tourmens	tourments
tormente	tourmente
traîtres	traitres
trempee	trempée
tres	très
thresors	tresors
tresors	trésors
tresor	trésor
troisiesme	troisième
trouverent	trouvèrent
trouva	trouvoit
treuve	trouve
trouver	treuver
trouvé	treuvé
trouvé	trouvé
toy	toi
tirant	tyran
valee	vallee
vault	vaut
venerable	venérable
venoit	venait
vinst	vint
vifz	vifs
vivoit	vivait
vit	vid
veuz	veux
veux	voeux
voicy	voici
voyes	voies
voila	voyla
voila	voilà
voyait	voyoit
voy	vois
voy	voye
voy	voi
voi	voye
voi	vois
voit	voy
voy	void
void	voit
voise	voye
voye	void
voyant	voyans
veu	veuë
veu	vû
vû	vu
volontez	volontés
voulenté	volonté
voz	vos
vostre	votre
vostre	vôtre
vôtre	votre
voudroit	voudrait
voulait	vouloit
vueille	veuille
vray	vrai